장애영역별,특수학교,일반학교 특수학급,일반학교 일반학급(전일제 통합학급),특수교육 지원센터,계
시각장애,1079,207,458,1,1745
청각장애,560,689,1646,12,2907
지적장애,14540,35855,5457,15,55867
지체장애,3905,3232,2326,59,9522
정서·행동장애,68,1186,577,0,1831
자폐성장애,7781,10183,1307,4,19275
의사소통장애,206,1396,1042,1,2645
학습장애,10,628,399,0,1037
건강장애,13,109,1834,0,1956
발달지체,780,8508,3428,202,12918
계,28942,61993,18474,294,109703
